###############                    #############################################
#.............#                    #..................#........................#
#........&....#################    #.......#..&&&.....#........................#
#...&........##...............#    #.......############........................#
#.........&...#.......&.......#########...............#........................#
#.............#...&...................................#........................#
######....#####.......................................#........................#
#.....................................................#........................#
#.....................................................###########...........####
&&&..&&&&......................................................................#
&&&&&..&.......................................................................#
&&&&...........................................................................#
#&&............................................................................#
#..&&..........................................................................#
#...&..........................................................................#
#...........................................................................####
#.......................................................###................#...#
#.....#................###...####...................####...#.............##....#
###.##.###..........###   ###    ##...............##........##..........#......#
   #      ####.....#               ####.......####............###..............#
              #####                    ####.##   #.........&&....####..........#
                                           #      ##......&....................#
                                                    #.....&&.............&&&&..#
                                                   #...............&....&&.....#
                                                    #........&....&&&..........#
                                                     #..............&..........#
                                                     ###########################