################################################################################################################################################################################################################################################################
#...................#&......................#...........&&&...................#......&&&&&&&&&&&&&&........................................................................................................############...............#.....................#..#
#...................#...........&&..........#.......&&...&&&...................#......&&&...&&&&&&...................&&&&&.......&&&&&........##########################.........####.................................#...............#.....................#..#
#...................#&.........&&.&&........#..............&&&.................#.......&.....&&&&.................##########..#################........................&&&&&&&&&&&###############..........#..........#...............#.....................#..#
######...############..........&....&...................&&&.....................#.............&&.................#................&&&&&&&.....................&&...........&&&&&&&###...........#..........#..........#...............#.....................#..#
#...................#....&..................#...................................##................................#.....................&&&&&...............&&&&&.............&&&&###...........#..........#..........#...............#.....................#..#
#...................#&..&&&..................#................&..................#..&&&............................#..........&&...........&&&...........&&&&&..................&&###......................#..........############....#.....................#..#
#...................############............#................&&&.................#...&&&.....&&&...............&&&&&#........&&&&.......&&&...............&&&....................&###...........#..........#.....................#....#.....................#..#
#...................#...........#....&&.....#...............&&&&&................#&&&&&....&&&.............&&&&&&&&...#.........&......&&.........................................###############..........#.....................#....#.....................#..#
#................................#..&&.....#.................&&&.................#..........&&.&&..........&&&&&.......##.......&..&&&...............#............................###...........#..........#.....................#....##############.########..#
#.................................#########...................&..................#..............&&.....................##......&&&&...................#&&&&.......................###...........#................................#.............................#
#&.........................................########........................&&&...#................&&....................#...&&&.......................#&&&&&&&....................###......................#######################.............................#
#############.....................................###.......&&&&&&&&&....&&&..&&&.......................................#...............&&&............#&&&&&&&...................###...........#..............................................................#
#...&.&......############...........................#......&.......&&&..&&&...................&&.........................#.............&&&&&............#.........................###############..............................................................#
#.&....&.................########################...&&&&.&&..................................&&......................#####............&&&&&&&............#........................###...........#..........############.............#########################..#
#&&..........&&&.........................&......#...&&..&&......................................................#####................&&&&&&&&&...........##.......................###...........#..........#..........#.............#.......#...............#..#
#&......&&..&&&.&&&.......................&&...............................................................#####......................&&&&&&&.............#############..........&###.................................#.............#.......#...............#..#
#&&.......&&&.....&&.......................&&...#&........&&...........................#############...................................&&&&&...............&&&&.......##########&&###############..........#..........#.............#.......#...............#..#
#&.............................&&&..............#&&&........&&.............#############.........#####..........##..##....................&&&...............&&.................&&&###......................############.....................................#..#
#.............................&&&&&&&&&&........#&&..........&&&....#############.....................#####..............................................&&&&.................&&&&###...............................................#.......#...............#..#
#...........&&&......................&&&&&&&&...#&..........&&&.....##..........................................##..##..........&&&&&....................&...................&&&&&###...............................................#.......#...............#..#
#.........&&&&&&&.......#########################..................#...........................................................&&&&&....................&&..................########................................................#.......#...............#..#
#..#######################.......................................##................................................................&&&...............&&&&&&.............................................................##########..#########################..#
#..........................................&&&&&&&.............##..........#..#.............##..##..##..##..##..##............&&&&&&&&&..............&......................#######.....................................#........#.............................#
#............................................&&&&&&&..............#.........................................................&&&..............&&&&&&&&...............&&&&&&...&&&&&##....................................#........#.............................#
#..............................................&&&..............#..........#..#...............................................&&...............................&&&&&&.........&&&&###...############.....############...#........###...........................#
#................&&&&&&&&..............................&&&..................................##..##..##..##..##..##..........&&&............................&&&&................&&&###...#..........#.....#..........#...#..........#...........................#
#&&............&&&&&&&&&&&&&&&&............................................#.................................................&.............................&....................&&###...#...........................#...#..........#.....#############.........#
#&...........&&&&&&&&&&&&&&&&&&&&...................&&&........#..............................................................&............................&.....................&###...#..........#.....#..........#...###.########.....#...........#.........#
#&&&........&&&&&&&&&&&&&&&&&&&&&&&&&&&&&&.......................#.........#..#.............##..##..##..##..##..##.............&...........................&.......&&.............###...############.....############....................#...........#.........#
#&&..............&&&&&&&&&&&&&&...................................##...........................................................&..........................&.......&&&&............###....................................................#...........#.........#
#&..............&&&&&&&&&&&&&&.....................................#.......#..#................................................&...................&&&&&&&.........&&.............###...############.....############................##########..###########...#
#........&&&&&&&&&&&&&&...........................................#.............................................................&..................#..............................###...#..........#.....#..........#................#.....................#...#
#.................................................&&&&&&..........#.........................................................&&######...............#..............................###...#...........................#................#.....................#...#
#..............................&&&&&&............&&&&&&&&.....&&&&&&.......................................................&&.......#.............................................###...#..........#.....#..........#................#.....................#...#
#.............................&&&&&&&&......#######################....&&&&&&&&...........................................&&.........##...........................................###...############.....############................#.....................#...#
#&.....................#######################...#..........................&&&&&&&&.....&&&&&&&&................&&.....&&.............###........#&&.............................###................................................#.....................#...#
#&&..................&&&&&&......................#................................&&&&&&&&....................&&&&....&&..................###....#..&&...........................&###...############.....############................########..####..#######...#
#&&&...............&&&&&&........................#.....................................................&&&&&&&&............................######...&...........................&&###...#..........#.....#..........#................#.....................#...#
###########...##########......###########........#.....................&&&&.....................&&&&&&&&.......................................................................&&&###...#...........................#................#.....................#...#
#.........#...................#..................#&...............&&&&&&&..........................&.................&&&....................................&&&&&&&&..........&&&&###...#..........#.....#..........#................#.....................#...#
#..#..#...#..###########......##############.....#&&.............&&&&&&&&&&.........................&...............&&&........&&&.....................&&&&&&&&.............#########...############.....############................#.....................#...#
#..#..#####..#.........#...................#.....#&&&...........&&&&&&&&&&&&.......................&...............&&&.......&&&.....................................................................................................#.....................#...#
#..#.........#....######...................#.....#&&.............&&&&&&&&&&............&&&.........&........................&&&......................................................................................................#.....................#...#
#..#..########....#................#########.....#&...............&&&&&&&...............&&&&......&..........................&&&...........................................#########.................................................#######################...#
#..#..#...........#&...............#.............#..................&&&&...............&&&&........&..................................................&&&..........###########&&&&###..........................................................................#
#..#..#...........#&&..............#.............#&&&................................&&&&&&&........&&............................................&&&&&&...........#...&&&&....&&&#############################################...##############################
#..#..#..#######..#&&&.............#.............#&&&&................................&&&............&&&&.......&&&........&&&&&&&..................&&&............#............&&#############################################...##############################
#..#..#..#.....#..##################.............#&&&...................................................&......&&&&&......&&&&&&&&&...............&&&..............#&............&##############################################.###############################
#..#..#..#.....#.................................#&&....................................................&&....&&&&&&&....&&&&&&&&&&&................&&&............#&&................&&&&&&&&...............................&&#.#&&#
#..####..#.....################...#################......................................................&################################.........................#&&&.................&&&&..................................&#.#&##
#........#........................................#.......................................................&........................................................#&&&&.............................................###########.###########
#################......#####.......######.........#........................&&&&&...........................&&......................................................#&&...............................................#.....................#
#......................#####.......######................................&&&&&&&&..........................&&......................................................#&.............&&&&...............................#......##..##..##.....#
#.################..##########..###################.....................&&&&&&&&&&..........................&.........##..##.......................................#.........&&&&&&&&&&&&&&..........................#.....................#
#........#..........#..............................#...................&&&&&&&&&&&&.........................&........................&&&&&&&.......................#........&&&&&&&&&&&&&&&&.........................#....##..##..##..##...#
#........#..........#...............................#...................&&&&&&&&&...........................&.......##..##..##.......&.............................#.......&&&&&&&&&&&&&&&&&&........................#.....................#
#........#..........#............&&&................#......................&&&&............................&........................&&.............................#.........&&&&&&&&&&&&&&..........................#..##..##..##..##..##.#
#........#..........#...........&&&.................#................................................&&&&&&........................&&&.............................#..........&&&&......&&&&&&.......................#.....................#
#........#..........#..........&&&&&.................#.............................&&&&&&......&&&&&&.....#########...............&&&&.............................#.......................&&&&&&....................#######################
#........#..........#...........&&&..................#....................................&&&&&&..........#.....................&&&&&&.............................#........................&&&&..............&&&&&&&#
#..##################............&...................#..................&&&&&&....................................#........&&&&&&..................................#.........................................&########
#..#..................................................&&&&&&........&&&&&&........................................#...&&&&&&.......................................#.........................................&#
#..#........&&&................................................&&&&&&.....................................##.....&&&&&&..........................................&&..........................................&#
#..#.......&&&&&...........................................................................................#&&&&&&...............................................&.....................................&&&&&&&#
#..#........&&&.................................&&&..............................................................................................................&.................................&&&&&&&#####
#..#...................................&&&.....&&&&&..........................................................................................................&&&&..............................&&&&&&&&###
#..##.................................&&&&&...&&&&&&&&..................................................................###############...................&&&&..................................&########
#..#######################...############################..................................................#............#......#......#..................&&&&..................................&##
#..######################.....###########################&.................................................##...........#......#......#.................&&&&..........................&&&&....&##
#..#####################.......##########################&&&&...............................................#...........##....###....##................&&&&.........................&&&&&&&&&&&#
#......................................................##&&&................................................#....................................&&&&&&&&&........&&&.................&&&&&&&&##
#......................................................##&&..............&&&&&&.............................#..............................&&&&&&................&&&&&......................&##
#......................................................##&...............&&&&.....########..................#..........................&&&&&......................&&&......................&##
#.......&...................................&..........##...............&&...............####################.......................&&&&.................................................&&##
#......&&&.................................&&&.........##..............&..................#.................#....................&&&&.....&&&...........................................&&##
#.....&&&&&...............................&&&&&........##....&&&&&.....&..................#.................&..................&&&.....&&&&&&&&&........................................&##
#......&&&.................................&&&.........##&&&&&....&&&&&...................#..................&&&&&&&&&&&......&&........&&&&&&&.............&&&&&......................&##
#.......&...................................&...........#.................................#&............................&&&.&&............&&&..............&&&&&&&..........#############
#.........................................................................................##&..............................&....................................&...........#
#.......................................................#...........#....##..##..##..##....#&&.............................&..................................&&............#
#......................................................##..................................#&&&............................&..................................&.............#
#......................................................##...........#....##..##..##..##....#&&&&...........................&..............................&&&&&.............#
#......................................................##..................................#&&&&&..........................&&&&&&&&&&&................&&&&&&................#
#......................................................##...........#....##..##..##..##....#&&&&.........&&&.........................&&&&&&&&&&&....&&&&&...................#
#......................................................##..................................#&&&.........&&&&&.....................................###########################
#&....................................................&##...........#....##..##..##..##....#&&.........&&&&&&&...................................&.....................##
#&&&&..............................................&&&&##..................................#&...........&&&&&..................................&&......................#
#&&&&&&&........................................&&&&&&&##..................................#...............&&&.................................&.......................#
#&&&&&&&&&&..................................&&&&&&&&&&######.....##########...............#................................&&&...............&....................&&&&&
#&&&&&&&&&&&&&............................&&&&&&&&&&&&&##..................#################...............................&&&&&............&&.................&&&&&
#&&&&&&&&&&&&&&&&......................&&&&&&&&&&&&&&&&##...............................................................&&&&&&&&&&&........&&.................&....#
#&&&&&&&&&&&&&&&&&&&................&&&&&&&&&&&&&&&&&&&##..............................................................&&&&&&&&&&&&&.......&.................&&....#
#&&&&&&&&&&&&&&&&&&&&&&..........&&&&&&&&&&&&&&&&&&&&&&##...................&&........................................&&&&&&&&&&&&&&&..............................#
#&&&&&&&&&&&&&&&&&&&&&&&&&....&&&&&&&&&&&&&&&&&&&&&&&&&##.........&&.......&&&&........................................&&&&&&&&&&&&&.....................&&.........#
###########################..############################.........&&..........&&&&.......................................&&&&&&&&&.........&...........&&&&..........#
###########################..############################........&&..............&&&&......................................&&&&&.........&&.&&&&...&&&&...............#
#..................................................&&&&&&&&&&&..&&.................&&&&...........&&&.................................&&&......&&&&...................#
#............................................................&&&&&&&&&&&.........&&&&............&&&&&................................&...........................&&&&&&
#.............................................................###......&&&&&&&&&&&.............&&&&&&&&..............................&..............................&&&&&&
#............&&&&&&&&&&&.......................&&&&&........###...............&&&&&&&&&&&.......&&&&&&&&&..........................&&................................#########################################
#...........&&&&&&&&&&&&&...................&&&&&.............#......................&&&&&&&&&&&&&&&&&&&&&......................&&&&.................................#########################################
#............&&&&&&&&&&&...................&&&&&&&&.............................................&&&&&&&&&&&.....................&...........&&&......&&&.............#########################################
#..............&&&&&&...........................&&&&&&................#..................................&&&&&&&&&&&...&&&&&&&&&...........&&&&&&...&&&&&..........&&&#########################################
#..............&&&&&&&&&&&........................&&&&&&.............#......#...........................................&&&&&&&...............&&&&&&.............&&&#####&&&...............................&&&#
#................................................................####......#........&&&&&&&&&&&..........................&&&&&.................&&&&&............&&&#####&&...................................&&#
#...............................................................#.........#..&&&&&&&&&&&..................................&&&...................&&&.........&&&...#####&.......................................&#
#&&&...........................................................#........##############.....................................&..............................&&&....#####........###########################........#
#&&&&&......................................................##############.......#........................................&&&...................................#####........#...........................#........#
#&&&&&&&.............................................##############...............#......................................&&&&&........&&&......................#####........#.............................#........#
#...&&&&&&&&.........................................&&&&#...............&&&......&#.................&&&&&&.............&&&&&&&......&&&......................#####........#...............................#........#
#....&&&&&&......................................&&&&&&&&#................&......&&&#.......&&&&....&&&&&&&&...........&&&&&&&&&.............&&&.............#####........############......................#........#
#.....&&&.................................&&&&&&&&&&&&&&&#........................&&&#.....&&&&&&..&&&&&&&&&&.........&&&&&&&&&&&..........&&&&&&...........#####....................#.......................#........#
#...........................................&&&&&........#.........................&&&############################.#############################################.....................#........................#........#
#..................&&&&&&&&&....................&&&&.....#..........................&&&###########################.#############################################.....................#.........................#.......#
#...................&&&&&&&.................&&&&&&&....#................................##########################.#############################################.....................#..........................#......#
#............&&&&&&&&&&...........................&....#................................##########################.#############################################.................................................#.....#
#.............&&&&&&&&...............................#................&&&...............##########################.#############################################..................................................#....#
#...............&&&&...............................&#................&&&&&........................................................................................................................................#....#
#..................&&.............................&&#...............&&&&&&&.............##########################.#######################################.#####..................................................#....#
#................................................&&&#................&&&&&.............###########################.#######################################.#####..................................................#....#
#...............................................&&&&&#................&&&..............###########################.#######################################.#####.................................................#.....#
#.....................................................#................................###########################.#######################################.#####.....................#..........................#......#
#.....##..##..##..##..##..##...........................#..............................############################.#######################################.#####.....................#.........................#.......#
#..................................................###..#......................&.....#&&&&&........................#                                #...........#....................#........................#.......#
#.....##..##..##..##..##..##.......####..............###......................&&&....#&&&.....................#####                                 #&&..........#...................#.......................#.......#
#.................................######........##############.....####........&.....#&&............###########                                      ####..##.....#.......############......................#.......#
#.....##..##..##..##..##..##......######.........############.........######........#..............#                                                  #..##........#.......#...............................#.......#
#..................................####............#.......................#########...............##                                                 #.............#.......#.............................#.......#
#...................................................#...............................................#                                                 ##.............#.......#...........................#.......#
#.....#..#..#.......#..#..#..........................#............................................##                                                   ##.............#.......###########################.......#
#.....................................................#...............############..............###                                                      #.............#&.....................................&#
#.....#..#..#.......#..#..#.......................................############.......#.........#                                                          #.............#&&.................................&&#
#.............................................................#############...........##......#                                                            ####..........#&&&.............................&&&#
##############################################################################################                                                              #################################################
